10,10,10,10,10,10,10,10,10,10,10,10,10,10,10,10,10,10,10,10,10,10,10,10,10
10,11,12,12,12,12,12,12,12,12,12,12,12,12,12,12,12,12,12,12,12,12,12,13,10
10,17,00,00,00,00,00,00,00,00,00,00,00,00,00,00,00,00,00,00,00,00,00,18,10
10,17,00,00,00,00,00,00,00,00,00,00,00,00,00,00,00,00,00,00,00,00,00,18,10
10,17,00,00,00,00,00,00,00,00,00,00,00,00,00,00,00,00,00,00,00,00,00,18,10
10,17,00,00,00,00,00,00,00,00,00,00,00,00,00,00,00,00,00,00,00,00,00,18,10
10,17,00,00,00,00,00,00,00,00,00,00,00,00,00,00,00,00,00,00,00,00,00,18,10
10,17,00,00,00,00,00,00,00,00,00,00,00,00,00,00,00,00,00,00,00,00,00,18,10
10,17,00,00,00,00,00,00,00,00,00,00,00,00,00,00,00,00,00,00,00,00,00,18,10
10,17,00,00,00,00,00,00,00,00,00,00,00,00,00,00,00,00,00,00,00,00,00,18,10
10,17,00,00,00,00,00,00,00,00,00,00,00,00,00,00,00,00,00,00,00,00,00,18,10
10,17,00,00,00,00,00,00,00,00,00,00,00,00,00,00,00,00,00,00,00,00,00,18,10
10,17,00,00,00,00,00,00,00,00,00,00,00,00,00,00,00,00,00,00,00,00,00,18,10
10,17,00,00,00,00,00,00,00,00,00,00,00,00,00,00,00,00,00,00,00,00,00,18,10
10,17,00,00,00,00,00,00,00,00,00,00,00,00,00,00,00,00,00,00,00,00,00,18,10
10,17,00,00,00,00,00,00,00,00,00,00,00,00,00,00,00,00,00,00,00,00,00,18,10
10,17,00,00,00,00,00,00,00,00,00,00,00,00,00,00,00,00,00,00,00,00,00,18,10
10,17,00,00,00,00,00,00,00,00,00,00,00,00,00,00,00,00,00,00,00,00,00,18,10
10,14,15,15,15,15,15,15,15,15,15,15,15,15,15,15,15,15,15,15,15,15,15,16,10
10,10,10,10,10,10,10,10,10,10,10,10,10,10,10,10,10,10,10,10,10,10,10,10,10

0,0,0,0,0,0,0,0,0,0,0,0,0,0,0,0,0,0,0,0,0,0,0,0,0
0,1,1,1,1,1,1,1,1,1,1,1,1,1,1,1,1,1,1,1,1,1,1,1,0
0,1,0,0,0,0,0,0,0,0,0,0,0,0,0,0,0,0,0,0,0,0,0,1,0
0,1,0,0,0,0,0,0,0,0,0,0,0,0,0,0,0,0,0,0,0,0,0,1,0
0,1,0,0,1,0,0,0,0,0,0,0,0,0,0,0,0,0,0,0,0,0,0,1,0
0,1,0,0,0,0,0,0,0,0,0,0,0,0,0,0,0,0,0,0,0,0,0,1,0
0,1,0,0,0,0,0,0,0,0,0,0,0,0,0,0,0,0,0,0,0,0,0,1,0
0,1,0,0,0,0,0,0,0,0,0,0,0,0,0,0,0,0,0,0,0,0,0,1,0
0,1,0,0,0,0,0,0,0,0,0,0,0,0,0,0,0,0,0,0,0,0,0,1,0
0,1,0,0,0,0,0,0,0,0,0,0,0,0,0,0,0,0,0,0,0,0,0,1,0
0,1,0,0,0,0,0,0,0,0,0,0,0,0,0,0,0,0,0,0,0,0,0,1,0
0,1,0,0,0,0,0,0,0,0,0,0,0,0,0,0,0,0,0,0,0,0,0,1,0
0,1,0,0,0,0,0,0,0,0,0,0,0,0,0,0,0,0,0,0,0,0,0,1,0
0,1,0,0,0,0,0,0,0,0,0,0,0,0,0,0,0,0,0,0,0,0,0,1,0
0,1,0,0,0,0,0,0,0,0,0,0,0,0,0,0,0,0,0,0,0,0,0,1,0
0,1,0,0,0,0,0,0,0,0,0,0,0,0,0,0,0,0,0,0,0,0,0,1,0
0,1,0,0,0,0,0,0,0,0,0,0,0,0,0,0,0,0,0,0,0,0,0,1,0
0,1,0,0,0,0,0,0,0,0,0,0,0,0,0,0,0,0,0,0,0,0,0,1,0
0,1,1,1,1,1,1,1,1,1,1,1,1,1,1,1,1,1,1,1,1,1,1,1,0
0,0,0,0,0,0,0,0,0,0,0,0,0,0,0,0,0,0,0,0,0,0,0,0,0